0,0,0,0,0,0,0,0,0,0,0,0,0,0,0,0,0,0,0,0,0,0,0,0,0,0,0,0,0,0,0,0,0,0,0,0,0,0,0,0,0,0,0,0,0,0,0,0,0,0,0,0,0,0,0,0,0,0,0,0,0,0,0,0,0,0,0,0,0,0,0,0,0,0,0,0,0,0,0,0,0,0,0,3,3,3,3,3,3,3,3,3,3,3
1,0,0,0,0,0,0,0,0,0,0,0,0,0,0,0,0,0,0,0,0,0,0,0,0,1,0,0,0,1,0,0,1,0,0,0,0,0,1,0,0,1,0,0,0,0,0,0,0,0,4,0,0,0,0,0,4,0,0,0,0,0,0,0,0,0,0,0,0,0,4,0,0,0,0,0,4,0,0,0,8,0,0,3,3,3,3,3,3,3,3,3,3,3
3,0,0,0,0,0,0,0,0,0,1,1,1,1,0,0,0,0,0,0,0,0,0,0,0,0,0,0,8,0,0,0,0,0,0,1,0,0,0,0,0,0,0,0,1,1,1,1,1,1,1,1,1,1,1,1,1,1,0,0,1,1,1,1,1,0,1,1,1,1,3,1,1,1,1,1,1,1,0,0,1,0,0,0,0,0,0,0,0,0,0,0,6,3
3,0,0,1,1,1,1,1,0,0,0,0,0,0,0,0,0,1,0,1,1,0,0,1,0,0,0,0,1,0,0,0,0,0,0,0,0,0,0,0,0,0,0,0,0,0,0,0,0,0,0,0,0,0,0,0,0,3,0,0,3,6,0,0,8,0,3,0,0,0,0,0,0,0,0,0,0,3,0,0,0,0,1,1,1,1,1,1,1,1,1,1,1,3
3,0,0,3,7,0,0,3,0,0,0,0,0,0,0,0,0,3,0,0,3,0,0,0,0,0,0,0,0,0,0,0,0,0,0,0,0,0,0,0,0,0,0,0,0,0,0,0,0,0,0,0,0,0,0,0,0,3,1,1,3,1,1,1,1,1,3,0,0,0,0,0,0,0,0,0,0,3,0,0,0,0,3,0,0,0,0,0,0,0,0,0,6,3
3,0,0,3,1,0,0,3,0,0,0,0,0,0,0,0,0,0,1,0,3,1,0,0,0,0,1,0,0,0,1,0,0,1,0,0,0,1,0,0,1,0,1,1,1,0,0,0,0,0,4,0,0,0,0,4,0,0,0,0,0,0,0,0,0,0,0,0,0,0,0,6,0,0,0,4,0,3,1,1,1,1,3,0,1,0,1,1,1,1,1,1,1,3
3,0,3,3,0,0,0,3,0,0,0,0,0,0,0,0,0,0,0,0,3,0,0,0,0,0,0,0,0,0,0,0,0,0,0,0,0,0,0,0,0,0,0,0,0,1,1,1,1,1,1,1,1,1,1,1,1,1,1,1,1,1,1,1,1,1,1,1,0,0,0,1,0,0,1,1,8,0,0,0,0,0,0,0,0,0,3,0,0,3,8,0,0,3
3,0,3,3,0,1,0,3,1,1,1,1,1,1,1,1,1,1,1,1,3,0,1,0,1,0,0,0,0,0,0,0,0,0,0,1,0,0,0,0,0,0,0,0,0,0,0,0,0,0,0,0,0,0,0,0,0,0,0,0,0,0,0,0,0,0,0,3,0,0,0,0,0,1,0,0,1,1,1,1,1,1,1,1,1,1,3,0,0,3,1,1,0,3
3,0,3,3,0,0,0,0,0,0,0,0,0,0,0,0,0,0,0,0,0,0,0,0,0,0,0,0,0,0,0,0,0,0,0,0,0,0,0,0,0,0,0,0,0,0,0,0,0,0,0,0,0,0,0,0,0,0,0,0,0,0,0,0,0,0,0,3,0,0,0,0,0,3,0,0,0,0,0,0,0,0,0,0,0,0,0,0,0,0,0,0,0,3
3,0,0,3,1,0,0,0,0,0,0,0,0,0,0,4,0,0,0,0,0,4,0,0,0,0,0,0,1,0,0,1,0,0,0,0,0,0,0,0,0,0,0,0,1,0,0,0,0,0,0,0,0,0,0,0,0,0,0,0,0,0,0,0,0,0,6,3,1,1,1,1,1,3,0,0,1,1,1,1,0,0,0,0,1,1,1,1,0,1,1,1,1,3
3,0,0,0,0,1,1,1,1,1,1,1,1,1,1,1,1,1,1,1,1,1,0,0,0,1,0,0,0,0,0,0,0,0,1,0,0,0,1,0,0,0,0,0,3,0,0,1,1,0,0,1,1,0,0,1,1,0,0,1,1,1,0,0,1,1,1,3,0,0,0,0,0,0,0,0,0,0,0,3,0,0,0,1,0,0,8,0,0,3,0,0,0,3
3,0,1,0,0,0,0,0,0,0,0,0,0,0,0,0,0,0,0,0,0,0,0,1,0,0,0,0,0,0,0,0,0,0,0,0,0,0,0,0,0,8,0,0,3,0,0,0,0,0,0,0,0,0,0,0,0,0,0,0,0,3,0,0,0,0,0,0,0,4,0,0,0,0,1,0,0,0,0,3,0,0,0,3,0,1,1,1,1,3,0,1,0,3
3,0,3,1,1,1,0,0,0,0,0,0,0,0,0,0,0,0,0,0,0,0,0,3,1,0,0,0,0,0,0,0,0,0,0,0,0,0,0,0,0,0,0,0,3,1,0,0,0,0,0,0,0,0,0,0,0,0,0,0,0,3,1,1,1,1,1,1,1,1,1,1,1,1,1,0,0,0,0,3,1,1,1,3,0,3,0,0,0,0,0,3,0,3
3,0,3,3,3,3,0,0,0,0,0,0,0,0,4,0,0,0,0,0,0,0,1,3,0,0,0,0,0,4,0,0,0,0,0,0,0,4,0,0,0,0,0,0,3,0,0,0,0,0,0,0,0,0,0,0,0,0,0,4,0,0,0,0,0,0,0,0,0,0,0,0,0,0,0,0,8,4,0,0,6,3,0,0,0,0,0,0,0,0,1,3,5,3
3,1,3,3,3,3,1,1,1,1,1,1,1,1,1,1,1,1,1,1,1,1,3,3,1,1,1,1,1,1,1,1,1,1,1,1,1,1,1,1,1,1,1,1,3,1,1,0,0,1,0,0,1,0,0,1,0,0,1,1,1,1,1,1,1,1,1,1,1,1,1,1,1,1,1,1,1,1,1,1,1,3,1,1,1,1,1,1,1,1,3,3,1,1
ENDMAP

LOADZOMBIE
0,55,530,0,0

LOADZOMBIE
0,300,530,3,0

LOADZOMBIE
0,720,530,2,0

LOADZOMBIE
3,720,530,3,3

LOADZOMBIE
3,700,370,2,1

LOADZOMBIE
2,1340,530,2,500

LOADZOMBIE
2,1640,530,2,500

LOADZOMBIE
0,1340,530,3,0

LOADZOMBIE
1,1340,530,2,4300

LOADZOMBIE
0,1640,530,3,0

LOADZOMBIE
1,1640,530,2,4300

LOADZOMBIE
0,1070,530,3,0

LOADZOMBIE
0,490,250,3,0

LOADZOMBIE
0,600,250,3,0

LOADZOMBIE
3,500,250,4,1

LOADZOMBIE
2,500,360,2,600

LOADZOMBIE
0,2110,50,3,0

LOADZOMBIE
0,2360,130,2,0

LOADZOMBIE
2,3000,50,4,300

LOADZOMBIE
0,3200,160,2,0

LOADZOMBIE
3,3150,160,2,4

LOADZOMBIE
0,2100,210,3,0

LOADZOMBIE
1,2900,330,2,5000

LOADZOMBIE
1,2800,330,3,7000

LOADZOMBIE
1,2750,300,2,3000

LOADZOMBIE
2,3300,500,1,1000

LOADZOMBIE
0,2500,450,3,0

LOADZOMBIE
0,3000,450,3,0

LOADZOMBIE
0,3050,530,1,0

LOADZOMBIE
2,2420,530,2,200

LOADZOMBIE
0,3240,450,2,0

LOADZBOMIE
0,3260,450,3,0

LOADZOMBIE
0,3230,530,2,0