0,0,0,0,3,0,0,0,0,0,0,0,0,0,0,0,0,0,0,0,0,0,0,0,0,0,0,0,0,0,0,0,0,0,0,0,0,0,0,8,0,0,3,0,0,0,0,0,0,0,0,0,0,0,0,0,0,0,0,0,0,3
0,0,0,0,3,0,0,0,0,0,0,0,0,0,0,0,0,1,1,1,1,1,1,1,1,1,1,0,1,1,1,1,1,1,1,1,1,1,1,1,0,0,3,0,0,1,1,1,1,1,1,1,1,1,1,1,1,1,1,1,0,3
0,0,0,0,3,0,0,0,0,0,0,0,0,0,0,0,0,3,0,0,0,0,0,0,0,0,0,0,0,0,0,0,0,0,0,0,0,0,0,0,1,0,3,1,0,0,0,3,0,0,0,0,0,0,0,0,0,0,0,0,0,3
0,0,0,0,3,0,0,1,1,1,1,1,0,1,0,0,0,3,0,1,1,1,1,1,1,1,1,1,1,1,1,1,0,1,1,1,1,1,1,8,0,0,3,0,0,8,0,3,0,1,1,1,0,0,0,0,0,0,0,0,0,3
0,0,0,0,0,1,0,3,3,3,3,3,0,3,0,0,1,3,0,0,0,0,0,0,0,0,0,0,0,0,0,0,0,0,0,0,0,0,0,1,1,1,0,0,0,1,1,1,0,3,0,0,1,0,0,8,0,0,0,0,1,3
0,0,0,0,0,0,0,0,0,0,0,0,0,3,0,0,0,3,1,0,0,0,0,0,0,4,0,0,0,0,0,0,1,1,1,1,1,0,0,3,3,0,0,1,1,3,5,0,0,3,0,0,0,0,0,1,0,4,0,0,0,3
4,4,4,4,4,4,4,4,1,1,1,1,1,3,1,1,0,3,0,0,0,0,1,0,0,1,1,1,1,1,1,0,3,0,0,0,0,8,0,0,3,0,0,0,3,3,1,1,1,3,0,0,0,0,0,0,0,1,1,1,0,3
3,3,3,3,3,3,3,3,0,0,0,8,0,0,0,0,0,3,0,0,1,0,3,1,0,0,0,8,0,0,0,0,3,0,0,0,0,1,1,1,3,1,0,0,3,0,0,0,0,3,6,0,0,0,0,4,0,0,3,0,0,3
0,0,0,0,0,0,0,0,0,1,1,1,1,1,1,1,1,3,1,0,0,0,3,0,1,1,1,1,1,1,1,1,3,0,0,1,0,0,0,0,0,0,0,0,0,0,0,0,0,3,1,1,1,1,1,1,0,0,0,0,1,3
0,0,0,0,0,0,0,0,3,3,3,3,3,3,3,3,3,3,0,0,0,1,3,0,0,0,0,0,0,0,0,0,3,0,0,0,0,0,0,0,0,0,0,1,1,1,1,1,0,0,0,0,0,0,7,4,0,0,0,0,0,3
0,1,1,1,1,1,1,1,3,0,0,0,0,0,0,8,6,2,0,0,0,0,0,0,0,0,0,4,0,0,0,0,3,1,0,4,0,0,0,0,4,0,0,0,3,0,0,0,0,1,1,1,1,1,1,1,1,1,1,1,0,3
0,0,0,0,0,0,0,0,0,0,1,1,1,1,1,1,1,3,0,1,1,1,1,1,0,1,1,1,1,1,1,1,3,0,0,3,1,1,1,1,3,1,0,0,3,0,0,1,1,3,0,0,0,3,0,0,0,0,0,0,0,3
0,0,0,0,0,0,1,1,1,1,0,0,0,0,0,0,0,0,0,3,0,0,0,0,8,0,0,0,0,0,0,0,3,0,1,3,0,0,0,0,3,0,0,1,3,1,0,3,0,0,0,0,0,3,0,0,1,1,0,0,1,3
0,0,4,0,0,0,3,0,0,0,0,0,0,0,0,0,0,0,1,3,0,1,1,1,1,1,1,1,1,1,1,1,3,0,0,3,0,0,0,0,0,0,0,0,3,0,0,0,0,0,0,0,0,0,0,0,0,3,0,0,0,3
0,0,3,1,1,1,3,0,0,0,0,0,0,0,0,0,0,0,3,3,0,0,0,0,0,0,0,0,3,0,0,0,3,1,0,3,0,1,1,1,1,1,1,1,3,1,1,1,1,0,1,0,1,1,1,0,0,3,1,0,0,3
0,0,0,0,0,0,0,0,4,4,0,4,4,0,0,0,4,4,3,3,0,0,0,8,0,4,0,0,0,0,0,0,0,0,0,3,0,0,0,0,0,8,0,0,0,0,0,3,0,0,0,0,3,2,3,0,0,0,0,0,0,3
1,1,1,1,1,1,1,1,3,3,1,3,3,1,1,1,3,3,3,3,1,1,1,1,1,1,1,1,1,1,1,1,1,1,1,3,1,1,1,1,1,1,1,1,1,1,1,3,0,0,0,0,3,3,3,1,1,1,1,1,1,3
ENDMAP

LOADZOMBIE
0,450,210,1,0

LOADZOMBIE
0,530,410,1,0

LOADZOMBIE
1,570,610,2,5000

LOADZOMBIE
3,1120,290,2,4

LOADZOMBIE
2,1100,210,2,4000

LOADZOMBIE
3,1190,410,2,4

LOADZOMBIE
0,1240,490,1,0

LOADZOMBIE
1,1210,610,2,5000

LOADZOMBIE
2,1530,410,3,4000

LOADZOMBIE
1,1620,130,1,10000

LOADZOMBIE
2,1368,10,2,4000

LOADZOMBIE
0,1100,90,1,0

LOADZOMBIE
2,1600,530,3,4000

LOADZOMBIE
1,1710,610,3,6000

LOADZOMBIE
0,2320,610,3,0

LOADZOMBIE
3,2070,290,3,6

LOADZOMBIE
0,2200,10,1,0