0,3,3,3,3,3,3,3,3,3,3,3,3,3,3,3,3,3,3,3,3,3,3,3,3,3,3,3,3,3,3,3,3,3,3,3,3,3,3,3,3,3,3,3,3,3,3,3,0,0,0,0,0,0,8,0,0,0,0,0,3
0,3,0,0,0,0,0,3,3,3,3,3,3,3,0,0,0,0,0,3,3,0,0,0,0,3,3,0,0,0,0,0,0,0,0,0,0,0,3,3,3,3,3,3,0,0,0,3,0,1,1,1,1,1,1,1,1,1,1,0,3
0,3,0,0,4,0,0,0,0,0,0,0,0,0,0,0,4,0,0,0,0,0,0,4,0,0,0,0,4,0,0,0,0,0,0,0,4,0,0,0,8,0,6,3,0,0,0,3,0,0,3,0,0,0,0,0,0,0,3,0,3
0,3,0,1,1,1,1,1,1,1,1,1,1,1,1,1,1,1,0,1,1,1,1,1,1,1,1,1,3,1,1,0,1,1,1,1,1,1,1,1,1,1,1,3,0,1,0,3,1,0,3,0,0,1,1,0,1,0,3,0,3
0,3,0,0,0,0,0,0,0,0,0,3,3,3,3,0,0,0,8,0,0,0,0,0,0,0,3,3,3,3,3,0,0,0,0,0,0,0,0,0,0,0,0,0,0,3,0,0,0,0,3,1,0,0,0,1,3,0,3,0,3
0,3,1,1,1,1,0,0,0,0,0,3,3,3,3,1,1,1,1,1,1,1,1,1,1,1,3,0,0,0,3,1,1,1,1,1,1,1,1,1,1,1,1,1,1,3,1,1,1,3,3,0,0,0,1,3,5,0,3,0,3
0,3,0,0,0,0,0,0,0,0,0,0,0,0,0,0,0,0,0,0,0,0,0,0,0,0,0,0,0,0,0,0,0,0,0,0,0,0,0,0,0,0,0,6,3,0,0,0,0,0,0,0,0,1,3,3,3,1,3,0,3
0,3,0,0,0,0,4,0,0,0,0,0,0,1,1,1,1,1,1,1,1,0,1,1,1,1,1,1,1,1,0,0,0,0,0,0,0,4,0,0,0,8,0,1,3,0,0,0,1,1,1,1,0,0,0,3,7,0,3,0,3
0,3,0,0,0,1,1,1,1,1,1,1,0,0,0,0,0,0,0,0,0,0,0,0,0,0,0,0,0,0,1,1,1,1,1,1,1,1,1,1,1,1,1,3,3,1,1,0,0,0,0,0,0,0,0,0,1,0,0,0,3
0,3,1,0,0,0,0,0,0,0,0,3,0,0,8,0,0,0,0,0,0,4,0,0,0,0,0,0,0,0,0,0,0,0,0,0,0,0,0,0,0,0,0,0,0,0,0,0,0,0,0,0,0,1,0,0,0,1,1,0,3
0,3,0,0,0,0,0,0,0,0,0,3,1,1,1,1,1,0,0,1,1,1,1,1,1,1,1,0,0,0,0,0,0,1,1,1,1,1,1,1,1,1,1,1,1,0,0,0,1,0,0,0,0,0,0,0,0,6,3,0,3
0,3,0,1,0,0,0,0,0,0,0,0,0,0,3,0,0,0,0,0,0,3,0,0,0,0,0,1,0,0,1,0,1,0,0,0,0,0,0,0,0,0,0,0,3,0,0,0,0,0,0,0,0,0,0,1,1,1,3,0,3
0,3,0,0,0,1,1,0,0,0,0,0,0,0,3,0,0,0,0,0,0,0,0,0,0,0,0,3,0,0,3,0,0,0,0,0,4,0,0,0,0,0,0,0,3,0,0,0,0,0,1,0,0,0,0,0,0,0,3,0,3
0,3,0,0,0,0,0,0,0,1,1,0,0,0,3,0,1,0,1,0,1,1,1,1,1,0,0,3,6,0,3,1,1,1,1,1,1,1,1,1,1,1,1,0,3,1,1,1,1,1,0,0,1,0,1,0,0,0,3,0,3
0,0,0,0,0,0,0,0,0,0,0,0,0,1,3,0,3,0,3,0,3,3,0,0,0,0,1,3,1,0,0,0,0,0,0,0,0,0,0,0,0,0,0,0,3,0,0,0,0,0,0,0,0,0,3,1,0,1,3,0,3
0,0,0,0,0,4,0,0,0,0,0,0,0,0,3,0,0,0,0,0,0,0,0,4,0,0,0,0,0,0,0,0,0,0,4,4,0,0,0,0,0,0,0,1,3,0,0,0,0,0,4,0,0,0,0,0,0,0,0,0,3
1,1,1,1,1,1,1,1,1,1,1,1,1,1,3,1,1,1,1,1,1,1,1,3,1,1,1,1,1,1,1,1,1,1,3,3,1,1,1,1,1,1,1,3,3,1,1,1,1,1,1,1,1,1,1,1,1,1,1,1,3
ENDMAP

LOADZOMBIE
0,380,570,2,0

LOADZOMBIE
0,430,60,1,0

LOADZOMBIE
0,1000,170,2,0

LOADZOMBIE
0,1050,60,1,0

LOADZOMBIE
0,1600,60,2,0

LOADZOMBIE
0,1200,250,3,0

LOADZOMBIE
3,1900,170,2,4

LOADZOMBIE
0,1000,250,0.5,0

LOADZOMBIE
0,690,610,2,0

LOADZOMBIE
3,620,610,3,6

LOADZOMBIE
2,760,610,5,10

LOADZOMBIE
0,1220,610,4,0

LOADZOMBIE
1,1600,610,2,12000

LOADZOMBIE
3,1600,490,1,2

LOADZOMBIE
0,1900,490,3,0

LOADZOMBIE
0,2100,210,3,0

LOADZOMBIE
3,2150,210,4,8